TTTTT TT
TTTT  TT
RRRRRRRC
RRRRRRRV
CRRRRRRR
TT    TT
TT  TTTT
T  A   T