TTTT   T
TT    TT
RRRRRRCR
RRVRRRRR
RRRRCRRR
RRCRRRRR
RVRRRRRR
CRRRRRRR
TTTTT TT
RRRRRRRC
TTTT  TT
SUUUUUUU
RRRRRRRV
RRVRRRRR
CRRRRRRR
TT  TTTT
T      T
TTTT   T
TT    TT
RRRRRRCR
TTT TTTT
RRRRCRRR
RRRRRRRR
RRRRRRRR
RRRRRRRR
RRRRRRRR
T T TTTT
T T TTTT
T T    T
T T TT T
T T TT T
T   T  T
T     TT
CRRRRRRV
CRRRRRRV
CRRRRRRV
CRRRRRRV
TT  TTTT
T  A   T