TTTT   T
TT    TT
RRRRRRCR
RRVRRRRR
RRRRCRRR
RRCRRRRR
RVRRRRRR
CRRRRRRR
RRRRRRRC
TTTTT TT
TTTT  TT
SUUUUUUU
RRRRRRRV
RRVRRRRR
CRRRRRRR
TT  TTTT
T      T
TTTT   T
TT    TT
RRRRRRCR
RRVRRRRR
RRRRCRRR
RRCRRRRR
RRRRRRRV
CRRRRRRR
RRRRRRRC
T TTTTTT
T TTTTTT
T T    T
T T TT T
T T TT T
T   T  T
TTTT  TT
RRRRRRRV
RRVRRRRR
CRRRRRRR
UUUSUUUU
TT  TTTT
T  A   T