TTT TTTT
CRRRRRRR
TTTTTT T
CRRRRRRR
T TTTTTT
RRRRRRRV
TTTTTT T
RRRRRRCR
RRVRRRVR
RRRRCRRR
RRCRRCRR
RVRRRRRV
TTT   TT
TTT  TTT
SUUUUUUU
USUUUUUU
UUSUUUUU
UUUSUUUU
TTT   TT
TTT  TTT
SUUUUUUU
USUUUUUU
SUUUUUUU
TT    TT
RRRRRRCR
RRVRRRRR
RRRRCRRR
RRCRRRRR
RVRRRRRR
CRRRRRRR
RRRRRRRC
TTTTT TT
TTTT  TT
SUUUUUUU
RRRRRRRV
RRVRRRRR
CRRRRRRR
TT  TTTT
T      T
TTTT   T
TT    TT
RRRRRRCR
RRVRRRRR
RRRRCRRR
RRCRRRRR
RRRRRRRV
CRRRRRRR
RRRRRRRC
TTTTTTT 
T       
T TTTTTT
T      T
TTTTTT T
T      T
T TTTTTT
RRVRRRRR
RRRCRRRR
RRRCRRRR
RRRRRRRV
CRRRRRRR
CRRRRRRR
T TTTTTT
T TTTTTT
T T    T
T T TT T
T T TT T
T   T  T
TTTT  TT
RRRRRRRV
RRVRRRRR
CRRRRCRR
SUUUUUUU
TT  TTTT
T  A   T